{
  "width": 11,
  "height": 11,
  "legend": {
    "#": "⬛",
    ".": "⬜",
    "S": "⬜",
    "G": "🏁",
    "P": "🟦"
  },
  "grid": [
    "###########",
    "#S.......G#",
    "#.#####...#",
    "#.....#...#",
    "###.#.#.###",
    "#...#.#...#",
    "#.#.#.###.#",
    "#.#...#...#",
    "#.###.#.###",
    "#.....#...#",
    "###########"
  ]
}
